#########################################################################
#                 #     #                                   #     #     #
#                 #     #                                   #     #     #
#                 #     #                                   #     #     #
#                 #     #                                   #     #     #
#                 #     #                                   #     #     #
#############     #     #############     ###################     #     #
#           #                 #           #     #           #           #
#           #                 #           #     #           #           #
#           #                 #           #     #           #           #
#           #                 #           #     #           #           #
#           #                 #           #     #           #           #
#######     #######     #     #######     #     #######     #     #######
#                 #     #     #     #                 #           #     #
#                 #     #     #     #                 #           #     #
#                 #     #     #     #                 #           #     #
#                 #     #     #     #                 #           #     #
#                 #     #     #     #                 #           #     #
#     #######     #     #     #     #     #     #############     #     #
#     #     #           #                 #     #                       #
#     #     #           #                 #     #                       #
#     #     #           #                 #     #                       #
#     #     #           #                 #     #                       #
#     #     #           #                 #     #                       #
#     #     ###################     #######     #     #######     #######
#     #           #                       #                 #     #     #
#     #           #                       #                 #     #     #
#     #           #                       #                 #     #     #
#     #           #                       #                 #     #     #
#     #           #                       #                 #     #     #
#     #     #     #######     #############     #############     #     #
#           #           #                 #           #                 #
#           #           #                 #           #                 #
#           #           #                 #           #                 #
#           #           #                 #           #                 #
#           #           #                 #           #                 #
#     #     ###################     ###################     #############
#     #                 #                 #                             #
#     #                 #                 #                             #
#     #                 #                 #                             #
#     #                 #                 #                             #
#     #                 #                 #                             #
#######     #     #############     ###################     #############
#           #     #           #     #           #                       #
#           #     #           #     #           #                       #
#           #     #           #     #           #                       #
#           #     #           #     #           #                       #
#           #     #           #     #           #                       #
#######     #     #######     #     #     #     #######     #######     #
#           #     #     #           #     #     #           #           #
#           #     #     #           #     #     #           #           #
#           #     #     #           #     #     #           #           #
#           #     #     #           #     #     #           #           #
#           #     #     #           #     #     #           #           #
#     #######     #     #     #     #     #     #######     #     #######
#     #           #           #     #     #           #     #           #
#     #           #           #     #     #           #     #           #
#     #           #           #     #     #           #     #           #
#     #           #           #     #     #           #     #           #
#     #           #           #     #     #           #     #           #
###############################     #######     #############     #######
#     #     #                 #     #                 #     #           #
#     #     #                 #     #                 #     #           #
#     #     #                 #     #                 #     #           #
#     #     #                 #     #                 #     #           #
#     #     #                 #     #                 #     #           #
#     #     #     #     #######     #############     #     #     #     #
#                 #                                         #     #     #
#                 #                                         #     #     #
#                 #                                         #     #     #
#                 #                                         #     #     #
#                 #                                         #     #     #
#########################################################################
